111111111111111111111111111111111111111111111111111111111111
110000000011000000001000000000100000000110000000010000000001
110000000011000000001000000000100000000110000000010000000001
110000000011000Z0000100000000010000000011000Z000010000000001
110000000011000000001000000000100000000110000000010000000001
110000000011000000001000000000100000000110000000010000000001
110000000011000000001000000000100000000110000000010000000001
110000000011000000000000000000100000000110000000000000000001
110000000011000000001000000000100000000110000000010000000001
111111011111000000001000000000111110111110000000010000000001
110000000011000000001000000000100000000110000000010000000001
110000000011000000001000000000100000000110000000010000000001
110000000011000000001000000000100000000110000000010000000001
110000000011000H0000100000000010000000011000H000010000000001
110000Z0000000000Z00100000000010000Z0000000000Z0010000000001
110000000011000000001000000000100000000110000000010000000001
11000Z0000110000000010000000001000Z0000110000000010000000001
110000000011000000001000000000100000000110000000010000000001
111111011111000000001000000000111110111110000000010000000001
111111111111111011111111111111111111111111110111111111111111
111111111111111011111111111111111111111111110111111111111111
110000000011000000001000000000100000000110000000010000000001
110000000011000000001000000000100000000110000000010000000001
110000000011000Z0000100000000010000000011000Z000010000000001
110000000011000000001000000000100000000110000000010000000001
110000000011000000001000000000100000000110000000010000000001
110000000011000000001000000000100000000110000000010000000001
110000000011000000000000000000100000000110000000000000000001
110000000011000000001000000000100000000110000000010000000001
111111011111000000001000000000111110111110000000010000000001
110000000011000000001000000000100000000110000000010000000001
110000000011000000001000000000100000000110000000010000000001
110000000011000000001000000000100000000110000000010000000001
110000000011000000001000000000100000000110000000010000000001
110000Z0000000000Z00100000000010000Z0000000000Z0010000000001
110000000011000000001000000000100000000110000000010000000001
11000Z0000110000000010000000001000Z0000110000000010000000001
110000000011000000001000000000100000000110000000010000000001
111111011111000000001000000000111110111110000000010000000001
111111111111111111111111111111111111111111111111111111111111
