11111111111111111111
10000000011000000001
10000000011000000001
10000000011000Z00001
10000000011000000001
10000000011000000001
10000000011000000001
10000000011000000001
10000000011000000001
11111011111000000001
10000000011000000001
10000000011000000001
10000000011000000001
10000000011000H00001
10000Z0000000000Z001
10000000011000000001
1000Z000011000000001
10000000011000000001
11111011111000000001
11111111111111111111